4
0
0 0
14 14
- - 0 0 0 0 0 0 0 0 0 0 0 0 
- - 0 0 0 0 - - 0 0 0 - - 0 
0 0 0 0 0 0 - - 0 0 0 - - 0 
0 0 0 2 4 0 - - 0 0 0 0 0 0 
0 0 0 4 2 0 - - 0 0 0 0 0 0 
0 0 0 0 0 0 - - 0 0 0 0 0 0 
0 0 0 0 0 0 0 0 0 0 0 0 0 0 
0 0 0 0 0 0 0 0 0 0 0 0 0 0 
0 0 0 0 0 0 - - 0 0 0 0 0 0 
0 0 0 0 0 0 - - 0 1 3 0 0 0 
0 0 0 0 0 0 - - 0 3 1 0 0 0 
0 - - 0 0 0 - - 0 0 0 0 0 0 
0 - - 0 0 0 - - 0 0 0 0 - - 
0 0 0 0 0 0 0 0 0 0 0 0 - - 
