2
0
0 0
13 6
0 0 0 0 0 0
0 0 0 - 0 0
0 0 0 0 0 0
0 0 0 0 0 0
0 0 0 2 1 0
0 0 0 1 2 0
0 0 - 0 0 0
0 0 0 0 0 0
0 0 0 0 - 0
0 0 0 0 0 0
0 0 0 0 0 0
0 0 - 0 0 0
0 0 0 0 0 0
