3
0
0 0
15 15
- - - 0 0 0 - - - 0 0 0 - - - 
- - 0 0 0 0 0 0 0 0 0 0 0 - - 
- 0 0 0 0 0 0 0 0 0 0 0 0 0 - 
0 0 0 - 0 0 0 0 0 0 0 - 0 0 0 
0 0 0 0 0 0 0 0 0 0 0 0 0 0 0 
0 0 0 0 0 0 0 0 0 0 0 0 0 0 0 
- 0 0 0 0 0 1 2 3 0 0 0 0 0 - 
- 0 0 0 0 0 3 1 2 0 0 0 0 0 - 
- 0 0 0 0 0 2 3 1 0 0 0 0 0 - 
0 0 0 0 0 0 0 0 0 0 0 0 0 0 0 
0 0 0 0 0 0 0 0 0 0 0 0 0 0 0 
0 0 0 - 0 0 0 0 0 0 0 - 0 0 0 
- 0 0 0 0 0 0 0 0 0 0 0 0 0 - 
- - 0 0 0 0 0 0 0 0 0 0 0 - - 
- - - 0 0 0 - - - 0 0 0 - - - 
