3
0
0 0
6 6
2 3 0 0 2 3
3 2 0 0 3 2
0 0 0 0 0 0
0 0 0 0 0 0
2 1 0 0 2 1
1 2 0 0 1 2